11111111111011111-
10000000000011111-
10111111111111111-
10000000000011111-
11111111111011111-
10000000000011111-
10111111111111111-
10000000000011111-
11111111111011111