1111111111101111111-
1000000000001111111-
1011111111111111111-
1000000000001111111-
1111111111101111111-
1000000000001111111-
1011111111111111111-
1000000000001111111-
1111111111101111111